PDB ID,sequence,total_len,iso_position,ring_len,loop_position,loop_len,tail_len
5ZCN,DGMGEEFIEGLVRDSLYPPAG,21,9,9,14,5,7
7BW5,GPKGDFPDVGDGRILAG,17,8,8,11,3,6
2LTI,GLSQGVEPDIGQTYFEESRINQD,23,9,9,17,8,6
5TJ1,GVGFGRPDSILTQEQAKPM,19,8,8,14,6,5
1Q71,GGAGHVPEYFVGIGTPISFYG,21,8,8,19,11,2
2MMT,GGAGHVPEYFVRGDFPISFYG,21,8,8,19,11,2
2MMW,GGAGHVPEYFVRGDTPISFYG,21,8,8,19,11,2
8DYN,GHSVDRIPEYFGPPGLPGPVLFYS,24,9,9,22,13,2
2N6U,GLTQIQALDSVSGQFRDQLG,20,9,9,15,6,5
4NAG,GGPLAGEEIGGFNVPG,16,7,7,10,3,6
2MFV,GGPLAGEEMGGITT,14,7,7,10,3,4
5JQF,GIEPLGPVDEDQGEHYLFAGG,21,9,9,15,6,6
5UI7,GSDGPIIEFFNPNGVMHYG,19,8,8,17,9,2
5D9E,GTLTPGLPEDFLPGHYMPG,19,9,9,15,6,4
7JS6,LLGRSGNDRLILSKN,15,8,8,11,3,4
8SVB,GGGGPTPEYFLMPIDPAWLQANLPNTGKYN,30,8,8,28,20,2
7ZWJ,SKKSKPGDGIRGKGVRG,17,8,8,13,5,4
2N5C,GFGSKPLDSFGLNFF,15,8,8,12,4,3
5XM4,GPPGDRIEFGVLAQLPG,17,8,8,12,4,5
6Q1X,GVLGNDAEGITLLPLCFKPICIPTLPPLTGGHA,33,8,8,15,7,18
3NJW,GLPWGCPSDIPGWNTPWAC,19,9,9,14,5,5
7CU6,LCVIVQADWNCPGWF,15,8,8,12,4,3
7BZ8,LVAIVQADWNAPGWF,15,8,8,12,4,3
7BZ9,LVVAVQADWNAPGWF,15,8,8,12,4,3
6M19,LVVIVQADWNAPGFF,15,8,8,12,4,3
7BZA,LVVIVQADWNAPGWF,15,8,8,12,4,3
7BZ7,LVVIVQADWNAPGWY,15,8,8,12,4,3
2MW3,SLGSSPYNDILGYPALIVIYP,21,9,9,14,5,7
5OQZ,GAPSLINSEDNPAFPQRV,18,9,9,16,7,2
6XTI,GGGGRGYEYNKQCLIFC,17,8,8,12,4,5
6B5W,GVGFGRPDSILTQEQAKPM,19,8,8,15,7,4
2LX6,GAFVGQPEAVNPLGREIQG,19,8,8,15,7,4
6MW6,GGVGKIIEYFIGGGVGRYG,19,8,8,17,9,2
7EES,GTIDPQNSEEHPVLSRRLEN,20,9,9,16,7,4
5JPL,GRPNWGFENDWSCVRVC,17,8,8,12,4,5
2LS1,CVWGGDCTDFLGCGTAWICV,20,9,9,15,6,5
6XTH,GSRGWGFEPGVRCLIWCD,18,8,8,11,3,7
5GVO,GLPIGWWIERPSGWYFPI,18,9,9,14,5,4
1RPB,CLGIGSCNDFAGCGYAVVCFW,21,9,9,15,6,6
6AK0,CLGVGSCVDFAGCGYAVVCFW,21,9,9,15,6,6
6POR,GGDGSIAEYFNRPMHIHDWQIMDSGYYG,28,8,8,26,18,2
5UI6,GGKGPIFETWVTEGNYYG,18,8,8,16,8,2
2M37,GLSQGVEPDIGQTYFEESR,19,9,9,14,5,5
2N68,GLSQGVEPDIGQTYFEESRINQD,23,9,9,14,5,9
2N6V,GPTPMVGLDSVSGQYWDQHAPLAD,24,9,9,15,6,9
7LCW,GSKYSDTADESSYRW,15,9,9,13,4,2
2MLJ,SIGDSGLRESMSSQTYWP,18,9,9,16,7,2
